9 9
*#######*
# T     #
#    P  #
#    M  D
#    K  #
# T     #
#       #
#   T   #
*#######*
